........................................................................ [  8%]
........................................................................ [ 16%]
........................................................................ [ 25%]
........................................................................ [ 33%]
........................................................................ [ 42%]
........................................................................ [ 50%]
........................................................................ [ 59%]
........................................................................ [ 67%]
........................................................................ [ 76%]
........................................................................ [ 84%]
........................................................................ [ 93%]
........................................................                 [100%]
848 passed in 300.26s (0:05:00)
PYTEST_EXIT=0
