........................................................................ [  7%]
........................................................................ [ 15%]
........................................................................ [ 23%]
........................................................................ [ 31%]
........................................................................ [ 39%]
........................................................................ [ 47%]
........................................................................ [ 54%]
........................................................................ [ 62%]
........................................................................ [ 70%]
........................................................................ [ 78%]
........................................................................ [ 86%]
........................................................................ [ 94%]
......................................................                   [100%]
918 passed, 1 deselected in 390.66s (0:06:30)
PYTEST_EXIT=0
