........................................................................ [  8%]
........................................................................ [ 17%]
........................................................................ [ 25%]
........................................................................ [ 34%]
........................................................................ [ 42%]
........................................................................ [ 51%]
........................................................................ [ 59%]
........................................................................ [ 68%]
........................................................................ [ 76%]
........................................................................ [ 85%]
........................................................................ [ 94%]
..................................................                       [100%]
842 passed in 305.00s (0:05:04)
PYTEST_EXIT=0
